100 100 50
****************************************************************************************************
*    *     *  **  ***  *   *  ***    ***  ** * *  *     *     **    *     *    * **   ***  ** *    *
*     * * *** ** *****  *    * * *   * ** ***  *  *    *   * *  ****  * **   * *     * *** **   *  *
*     * * * * *   ** *    * *       *  *          *    ****   * *  *  **     *   *** ** *** * **   *
**  **    *        **        ** * *     *   *  * ** *   ** *        * *     *   *    **    *  **   *
*   *   *      **    ** * **    ***   ***    ****     *  * *             * *  * * *  ******    * * *
** * * * *      *****   **   * **    ** *   ** *    * *   *  * * *******  *    * * * *    * *      *
*       **         *** *  *    * * * **    ***   *   * **    * *  *  **       *     * ** * ** * ****
**   *  *  * ** ** ** **   *  *   *  ***  *******   *  * ***  * **** **** ** * * * **** *   *  **  *
* *  * *     *****    *  *** *   *  **  *     **   *    *   *  *    * ***   *     ***  * *   *  *  *
***    *****   *    *    *****   *    *      *       * **   *** *   * * * **    ***** *     ****   *
** *   *    *  * * * *   *  *  * *   * * *  * *  ***** ** **      * *  *  ** *  **  *  *  * * ** * *
** **  * **  *     *    ** **    *   * *   ***    ** ***  * *    **    * *   * *  * **  * **   * * *
*****      ***** * *  *   *     *  * ***  * *** *     ** * **  * ****** ** * *     *    * *** *    *
*     *      ***          ***  ****  **   **  *****   * **   * **  * *      *  *    ** * * * *   * *
**   ***  **     *   ***    ***    *  * ** **     ****     *   * ** *  *     *  *    **         ** *
**  * *      * *  * **   *        * **     * * *    **  **    * *****  ***  *          ***   *    **
*     **  * * *    *     *  ** * *   *        **   ***  *  *   * *  **  * *    **    *   ***   * * *
*     * *  **   **       **    * * *  **    ****** * * * *   *     **  *     * **** *         ***  *
*  * * *  ** **        **   *   **     *  **  * *        **   *  **    ** ****  ***   *   * ****** *
*    * ** * *  *   **  **  *         *     *** *  *   *   * *   **  *  **  ** * *  ** * **** *     *
* ** *** **   *  *  * **  *         *          *** *  *     **  * ***      ** ****** **    **  *** *
** *    *  ** ** *   * **  * ******  *   **   *   **  ***** **   * ** **  * ***     **  *   * *    *
* * ***  *    *       ** *   *  ***    *  *  *   **  *     *   **    * *  *   *  *     **    *   ***
*    *       **     * * *  *  *     ***       **    *** *        **   ***     **    * ***  ***  ** *
*      * **** *  *  * *            * ** *  ** *       *   *  * * ****      ** *   ** *  *      *  **
* *  * *  *   *   *  ***    *** * *    *      *   ** * *** * *     * ** **   **  * **    *  **  *  *
* *****  *    *   ** ***   **  ******  *   * * * *****           * *  *   *  * **   *  *   **  *  **
***** *  *  * *    *      *  ******  * ***  * *    * * *         *  **   ** * *      *  *        ***
* * * * **  *** ***  *** *   *     *      **     * **  * *  ** *  **    **     * **       **  *  * *
*    *   **** ** ***     ***  ****  **  ****   *   *** *  **  **  *    *  * *    * ***             *
*  * *    ** * *  * *    * * **    **    **      * * * *** **       * *  * *       *     *  *    ***
*   *    **         *  **    *    ***   *      *** * ** *    **  *       *  * ***   *  * * *      **
**          *     **   * *   *  ** *    *        ***  *    * *  ****     ****** ** *   ** *  *  * **
*    ** **** ***** ***  **  *  *  ** *  *   *** **  ****  * **     **  *  *  ****  **   * *  ***  **
* * *  *       *  * ***       * *    * * * *          **   ***     *  ** ***   **** **     *   * ***
*  * ** * * ** *  * *** *         ** *  * *** *        *** *    **    *  *   *      *       *  *   *
* *    ** * **    * *   ** ***  * *  *   *  *     *  ** *  **  * * **    *  * * * *  *     **    * *
*  * * *   **  * *** *  *       ***   **  *     *  *      *    ** *    * * *** *  * **       *  *  *
*           * *****     ** ** *     * **        *    **** ** *    *  *  *** * **  *    *   * * **  *
*  **   *    **  * **    ** ***      **          *        ** *  * *     ** * * ** **       *** *   *
* * *    *       **   * **   * *    ***      *     * *   **   ***   * *   ***    ***   *    *    ***
*   *** * * * **   *    **   *   *   **     * * ***   **     *    ***   *  ** *  ** *  ***   ** *  *
*** ****      ** *  *    *  **          * **  **     ******** * * *     * * *   ** ** ** * *    *  *
*  *      **  *  *   *     *  **  **   *    *    **  *    ** **  *  * * *   ** ***  * *  *** **   **
* ***           *    *  *  *  * *  **   *  *       *** *    * * ** *  * *    *  * ***    **   **  **
**    *   *  *        *     ** *** **      ***   *  *             * *     **     **     ****  * ** *
* *      ** *  *   ********* **  * *** *       **          *  * *  *  **   **      *    *  **      *
* *        ** **    *    *   ***   * * *          *  * * * ****    ***   *    *** *    *  *  *  ** *
** * **  * ***    **       *   * * *       *   *   **   ***    * ***       *  * *   * *  ***  *   **
*     * ** * **   *   *  *    * *    *  *      ** **   *    **** ****  ** *   *  *     *           *
*** * *** *           *****        **      **        *  *  * *   * * * *  * * ** * *****  ** *  *  *
** * *       *      ***        * * * * *** *        * *   * * * *    *      **  ** *   * **  * * * *
*  * * *       *       *   * **    *     *** **         ** * *   *    **  *  *****      ***   *  ***
*    **   *  *     ** **    *   **  *         **  **    **  ** **  *   * *         **** * ** *     *
*       *     *     *  ****  *          **   **     *****     ** **   *  *    ***** **    * *      *
***     *** **        * ***   ** *  * *  ***   * * *    *   * ** * *       ** *  **          * ** **
***   * * *     *** *  *****          * * * * *  ***  **  ***       * ***  **   * *     ** *  * *  *
****      *     **** *  ** *    *      * *   *    *   **  *       **    ***  * **  *  ** ****   * **
**     ****    *    ** ***    **    ** * * *  **    *  *  *  * * *    *  *     * *      * * *  *  **
***** *** *        ** ***     *  *  * *  *** * *    * * * *   **  ** * **   **   *     *   ** * *  *
*     ** ** *      * *  * *     *  * ***       * *   *    * ***    *  **     **   *  *  * ** *  ** *
* * *    ** * **   *  *  *        * *    *   **    **     *   *******         *           *****    *
* **** *    * * *    ** **   * * *  *   * ***           * *   **  * ** *  ** * *  *     *   * ***  *
** * *     * * * * * * *   *    *   * * *  ** *  ** *  *  * * **    **      *        * * *        **
*   *      **** *   ***     * *      *    *  *  ** *  *   ***    *  *       ** *   *   *     * * * *
* *    *  **     **  *      **  *       **   *    *          *  *  * * ******    *      *   *    * *
* **  *  *   * * **** * ****  ** *** *    *    ** ****     *   *  * **    *   *  *  ***    *****   *
** * *  *  * **    ***   ** *  * *  * **  *   *    ***  *    *  ***     ***   *      * ***        **
***    ***   * * * *   ***   *  *  ** *   *      *       * ***  *   *   ***     *      *     *   ***
*  *  *    *       *   * ** ** **   *     ***   * * *     * ****    *      * *    *   **  *  * *  **
* *  * **   ** * * *    ** *      **   *    * *** *   *  * * * ** **  ** *       ***     * * ** *  *
*     * *           *    *** *        *    **    ** *  *  *   *   * **      *     *** * **        **
* *  ***      *  *  *      **  *  **  * * *   **  * **         *****    **    *******    * *      **
* *******  *** *   * * ***  * ** **     *    * ****   *     * * **   **  **     * *  **   ** *   * *
*    *   * *  *    ** *      **       *     ****  *   * * *     ***    *** **  *   *** **   **  * **
*     *  ****  * *****  **      ** *        * *  *   *  **  ** ** * * * *  *   ***   *      *  * * *
*                * *  *  ** *    *   *  *** *     *  *   ** *  **  * *       * *      *   *** * *  *
* *   * * * * * *  ***  * *** * ***         * **  **   *    *  *   * *    *     ** *  **     * * * *
* ***    **  * ***  *       *   ** ***     **** ** *    * *     *  *   *      ** * *    * *  *     *
****         * *   *  * *      *  ** ***   * * **       **         ** *     *  ***    *      * **  *
***     *    ** * *   *** ** * **    **  *    * *   *        *  *       * *   *   ** *       * * * *
* ** ***       *  *  **  *  *  * **  ***    *  * *  ******         **   ***      * ** ** *      * **
**      *   *     ** **  ***  *   *     *  **    *  ** ** *    ** *   * * *** **  **  **  * * ** * *
*       *  **  *     **  *   * *   **  * **  * * *  **   *    *  * * * *   * ** **  **   * *     * *
*** *    *   *   *   *  * *    ** *   ** *  * *     *  *  *      ***  *  *    *       *  *****  ****
**      *  ***  *   *  **        *    *** * *  *    *  * ** * ***  * **   *  **  **  ****  ** *  * *
*** *** *  *    **  *   **     *    ** * * *       *  *  ***   *  *   **  * ****   **     **  *    *
***   * *    ***** * *  *    * *  ** * *       * **  *   *     *  *  *    ** *  *    **  * ** * * **
**  * *** * * *      * **    *      **  ****  **    * *  ****   * *  ** * *  **** ** * **     ***  *
**  * ** *       *     ***     * *   *   ***       ****           * * * ** *  **  ** * *  * ****** *
***  **       **  * ***       *  *     *    *  * *  * *     *   ***       * *    *** *        * ** *
* * * * **         *** * *  * *  **  ** *   * *    *  *       **  **    ** *    *  *    ***   * ** *
*      * *   ** ***     **  *  ***   *             **    * *  *    ** *   *** *        ****  * **  *
***    * **       ******       * *     *   *   ** **    **** *  **   *      ** *     ** ** ***   ***
**     *        *  * * **  ****** * * ***  * *   ****    * **     * ** *       **      *****    * **
****     *  ***    *   * *         * *****  ***      *   ***       **** *  * *  *** * *  *    *  * *
* * *** ***  * * *  * * **   *         *    *   *  ***  *    *   *      *    *   *  ***  **   **  **
* *     * * *      *  * *    *  *   ** **    ****     * *   ** *   *     **  ** * * *  * *  *   ** *
****************************************************************************************************
