20 20 3
********************
*    *  *****      *
***** * *   **    **
* **          *  * *
*    *     *  **   *
** ***    *       **
**   *** * *       *
* *   * *   * * *  *
**  **  **** *    **
* **  ** * *  * *  *
*      *   *** **  *
*  *   **  ***    **
*     *     * * * **
*   *  * *    **   *
* **  *  *      * **
*     **   *** *** *
*  *    ***   * *  *
****     *    *   **
*  **  **  *     ***
********************
